xxxxxxxxxxxxxxxxxxx
x        x        x
x        x        x
x        x   o    x
x                 x
xxxxxx            x
x                 x
x                 x
x                 x
x                 x
x      p          x
x           xxxxxxx
x                 x
x                 x
x                 x
x   o        o    x
x                 x
xxxxxxxxxxxxxxxxxxx